11000000
11000000
11111001
10100100
10110000
10011001
10010010
10000010
11111000
10000000
10010000
11000000
11111001
10100100
10110000
10011001
10010010
10010010
10010010
10010010
10010010
10010010
10010010
10010010
10000010
11111000
10000000
10010000
11000000
11111001
10100100
10110000
10011001
10011001
10011001
10011001
10011001
11000000
11000000
