11000000
11000000
11000000
11000000
11000000
11000000
11000000
11000000
11000000
11000000
11000000
11111001
11111001
11111001
11111001
11111001
11111001
11111001
11111001
11111001
11111001
11111001
11111001
11111001
11111001
11111001
11111001
11111001
10100100
10100100
10100100
10100100
10100100
10100100
10100100
10100100
10100100
11000000
11000000
